################
#              #
#       ########
#              #
#      ##      #
#      ##      #
#              #
###            #
##             #
#      ####  ###
#      #       #
#      #       #
#              #
#      #########
#              #
################