#####################################################
#                                                   #
#       ########################################### #
#              #        ##############              #
#      ##      # ######## ######################## ##
#      ##      # # ###    ########################  #
#              # # ##  ###                          #
###            # #  #  ### ######################## #
##             # #  ## ##  ##########################
#      ####  ### #                                  #
#      #       # ################################## #
#      #       #                                    #
#              #################################### #
#      #########                                    #
#              #                          #         #
############## #    #############         #         #
############## #                #         #         #
#              #                #         #         #
#  #############                #         #         #
#  #   #       #                #         #         #
#  #   #       #     ####                           #
#  #   #### ####         #                          #
#              #          #                         #
###            #          #       ##########        #
##             #          ##                        #
#      ####  ###          #                         #
#      #       #                                    #
#      #       #                                    #
#              #                                    #
#      #########     ###################            #
#              #                                    #
#####################################################